                                                      
                                                      
                                                      
######################                                                      
                                    #########                                                      
                                                      
                ##########################                                                      
       ######   PLATFORM PLATFORM PLATFORM                                                      
                                ############################                                                      
         #################                                                      
                                                      
                        ############################                                                      
                                                      
    ################                                                      